N
здддбдбдддддддддддддбдддддддддддддддддддддддддддддддддддддддддддддддддддддддддд©
Ё     Ё             Ё  Ё                                                       Ё
цд дед╢ здбдддд бд© Ё з╢ з дддддддд бддбдддддддддддддддбдддд дддддддддддддддд© Ё
Ё   Ё Ё   Ё     Ё Ё Ё юы Ё          Ё                       X                Ё Ё
Ё Ё Ё Ё Ё Ё дддба ╢ Ё    Ё здддддддд╢ за© зддддддддбддда ддддддддддддддддд © Ё Ё
Ё Ё Ё   Ё Ё/   Ё  Ё   зд©Ё цдддддддды Ё Ё Ё        Ё                       Ё Ё Ё
Ё Ё Ё Ё Ё юд дд╢ д╢ Ё Ё ЁЁ Ё          Ё Ё Ё Ё ддд© юддддддддбдддд Ё здддд© Ё Ё Ё
Ё Ё Ё Ё Ё      Ё  Ё Ё Ё ЁЁ Ё здд© цдддаба ╢ Ё    Ё          Ё     Ё цдддд╢ Ё Ё Ё
Ё Ё юды юддддддед   Ё Ё ЁЁ Ё Ё            Ё юддддадддддддд© Ё зд© Ё Ё    Ё Ё Ё Ё
Ё Ё            цддд Ё Ё юы Ё юддддадддде© Ё               Ё Ё Ё Ё Ё Ё з© Ё Ё   Ё
Ё юдддддддддддд╢    Ё Ё    Ё           ЁЁ цдддддддддддддд юд╢ Ё Ё Ё Ё ЁЁ Ё Ё Ё Ё
Ё              Ё дддада дддедддддддддд ю╢                   Ё Ё Ё Ё Ё ЁЁ Ё Ё Ё Ё
цддддддддддддбды                        Ё ц дддбдб дбдб бдд Ё Ё     Ё ЁЁ Ё Ё Ё Ё
Ё            Ё   зддддд зддддд ддддд ддды Ё    Ё Ё  Ё Ё Ё   Ё цддддб╢ ЁЁ Ё Ё Ё Ё
цдддддддддд© Ё зд╢      Ё                 цдд© Ё ю© Ё Ё Ё зды Ё    ю╢ ЁЁ Ё Ё Ё Ё
Ё          Ё Ё Ё Ё здб© Ё здддддддддд© дддадд╢    Ё Ё Ё Ё Ё     з©  Ё ЁЁ Ё Ё Ё Ё
Ё здбдддд© Ё Ё Ё Ё Ё ЁЁ Ё Ё          Ё       Ё ддд╢ Ё Ё Ё юдддддаадды ЁЁ Ё Ё Ё Ё
Ё   Ё    Ё Ё   Ё Ё Ё ЁЁ Ё Ё ддддддд© юддбддд Ё    Ё Ё Ё Ё             ЁЁ Ё Ё Ё Ё
Ё Ё цддд   Ё Ё Ё Ё Ё ЁЁ ц Ё        Ё    Ё    цдд© Ё Ё Ё юдддддддддддддаы Ё Ё Ё Ё
Ё Ё Ё    Ё Ё Ё Ё Ё Ё ЁЁ Ё юдддд© Ё юдбд ц© здадды Ё Ё                    Ё цд╢ Ё
Ё Ё юддд ╢ Ё Ё Ё Ё Ё ЁЁ        Ё Ё   Ё  ЁЁ Ё      Ё юд© здддддддддддддддд╢ Ё Ё Ё
Ё Ё          Ё   Ё Ё юадддд ддды юд© Ё даы Ё зддд Ё   Ё Ё                Ё Ё Ё Ё
Ё Ё здддддд© Ё Ё Ё Ё               Ё Ё     Ё Ё    цд© Ё Ё зддддддддддддд Ё Ё Ё Ё
Ё Ё          Ё Ё Ё Ё дддбд© ддддддды юддддд╢ юддддады Ё Ё Ё              Ё Ё Ё Ё
Ё Ё ддддбд   Ё Ё        юды                Ё          Ё Ё юддддддддддд Ё Ё Ё Ё Ё
Ё Ё     юдддды Ё ддддд©     зддддддддддддддадддддддддды Ё              Ё Ё   Ё Ё
Ё Ё з ©        Ё      цдб© д╢                           Ё ддддддддддддды Ё Ё   Ё
Ё Ё Ё юддддддддадддддды а╢  Ё зддддддддддддддддддддддддд╢                Ё Ё зд╢
Ё Ё Ё                    Ё д╢ юдддддддддддддддддддддддддаддддддддддддддд Ё Ё Ё E
Ё Ё ц© здддддддддддд© д© Ё  Ё                                            Ё ╢ Ё Ё
Ё Ё ЁЁ Ё            Ё  Ё Ё да© зддддддддддбдддддддддддддддддддддддддддддды Ё Ё Ё
Ё Ё юы юддддд© ббдд юд Ё Ё   Ё Ё          Ё                                Ё Ё Ё
Ё Ё          Ё ЁЁ      Ё Ё Ё Ё цддддд© з© Ё зддддддддддддддддддддддддддддддад╢ Ё
Ё цдддддддд© Ё ЁЁ зд© з╢ Ё Ё Ё юддддд╢ ЁЁ Ё Ё                                Ё Ё
Ё Ё        Ё Ё ЁЁ Ё Ё ЁЁ Ё Ё Ё       Ё ЁЁ Ё Ё ддбдддддддддддддбдддддддддддд© Ё Ё
Ё Ё зддддд Ё Ё ЁЁ Ё Ё ЁЁ Ё Ё цдбддд© Ё ЁЁ Ё Ё   юддддддддддддд╢            Ё Ё Ё
Ё Ё Ё      Ё Ё ЁЁ Ё   ЁЁ Ё Ё Ё Ё   Ё Ё ЁЁ Ё Ё Ё               Ё здддддддд© Ё Ё Ё
Ё Ё юдддддды Ё ЁЁ Ё Ё ЁЁ Ё Ё Ё Ё Ё Ё Ё ЁЁ Ё Ё Ё зддддддддддд© Ё Ё        Ё Ё Ё Ё
Ё            цдаы юдадаы Ё Ё Ё Ё Ё Ё Ё ЁЁ Ё Ё Ё Ё           Ё Ё Ё Ё здд© Ё Ё Ё Ё
Ё цдддддддддды           Ё Ё Ё Ё Ё Ё Ё ЁЁ Ё Ё Ё Ё дддддддд© Ё Ё Ё Ё юддедад╢ Ё Ё
Ё Ё            зддддд ддд╢ Ё   Ё Ё Ё Ё ЁЁ Ё Ё Ё Ё         Ё Ё Ё Ё Ё    Ё   Ё Ё Ё
Ё цдддддддддддд╢         Ё юддды Ё Ё Ё ЁЁ Ё Ё Ё Ё ддддддд Ё Ё Ё Ё юд© зы Ё Ё Ё Ё
Ё Ё            Ё ддд Ё Ё         Ё Ё Ё ЁЁ Ё Ё Ё Ё         Ё Ё Ё Ё   Ё Ё  Ё Ё Ё Ё
Ё Ё ддддддддддд╢     юдадддддддддад╢ Ё юы Ё Ё юды ддддддд Ё Ё Ё юд© Ё юдды Ё Ё Ё
Ё Ё            Ё зд©               Ё      Ё Ё             Ё Ё Ё   Ё Ё      Ё Ё Ё
Ё цддддддддддд Ё Ё юдддддддддддддд Ё дддддададдддддддддддды Ё юдд Ё юдддд ды Ё Ё
Ё Ё            Ё                   Ё                        Ё     Ё          Ё Ё
Ё юддд ддддддддадд ддддддддддддддддаддддддддддддддддддддддддадд ддаддддд© ддды Ё
Ё                                                                       Ё      Ё
юдддддддддддддддддддддддддддддддддддддддддддддддддддддддддддддддддддддддадддддды